1123131211
2     2  1
1     1  2
121      1
1     1  3
3        1
1   1    2
2   1    3
1   1    4
1221333132